28 2a 0J 1L 0c 3C 2o 0X
00 2Z 2d 1T 2u 1t 1j 0L
1o 1E 3T 18 3E 1G 27 0L
0v 2t 06 11 1A 2U 4B 1O
2M 3d 2S 0x 0w 0q 0p 2V
18 0q 1D 49 2O 00 1v 2t
1k 3s 3G 21 3w 0W 29 2r
2O 2L 0g 3Y 0M 0u 3i 3C
1r 2c 2q 3o 30 0a 39 1K

128 156 19 81 38 192 170 33
0 155 159 89 176 115 105 21
110 74 209 68 194 76 127 21
57 175 6 61 70 150 251 5
142 219 148 59 58 52 51 151
68 52 73 249 144 0 117 175
106 234 196 121 238 58 129 173
144 141 42 214 22 56 224 192
113 158 172 230 180 36 189 80
